Team,Gold,Silver,Bronze,Total,Rank by total
China,38,31,18,87,2
USA,36,39,33,108,1
Japan,27,12,17,56,5
Russia,20,26,23,69,3
Britain,20,21,22,63,4
Australia,17,7,22,46,6
Germany,10,11,16,37,8
Netherlands,10,11,12,33,9
Italy,10,10,19,39,7
France,9,12,11,32,10
