Team,Gold,Silver,Bronze,Total,Rank by total
China,24,14,13,51,2
USA,20,23,16,59,1
Japan,17,5,9,31,5
Australia,14,3,14,31,5
ROC,12,19,13,44,3
Britain,10,10,12,32,4
France,5,10,6,21,8
Korea,5,4,8,17,10
Italy,4,8,15,27,7
Netherlands,4,7,6,17,10
